a plethora of - 過多的
a solification of - 懇求
adhere to - 堅持，遵循
advertent - 注意的；留意的
afflict - 使苦惱
affront - 冒犯
all but - 幾乎
allegedly - 據說
alleviate - 減輕
allied - 類似的
appraisal - 評價
appreciably - 可觀的
appreciate - 升值
assail - (v)抨擊、猛攻
assuage - (v.) 緩和、減輕、鎮定
be immersed in water - be covered in water
brainchild - 創意；點子
bridle - 控制
ceaseless - (a.)不停的,不斷的
channel - 引導，傳送，供給
competent - 有能力的
complex - 複合體；體系
compulsory - 義務的
confer sth on sb - 給予
confer with sb on sth - 協商
conform - 遵守，順從
consecutive - 連續的
conspicuous - 明顯的
constituents - 選民
contiguous - 相鄰的
conundrum - 難題
convene - 召集，集會
cordial - 和藹的
cramp - 抽筋，阻礙
culminate in - 以...告終，達到...的頂點
cumbersome - (adj)笨重的、難處理的
decease - n.死亡
defer - 推遲，服從
defraud - 欺詐，詐騙
deliberate - 故意的，審慎的，深思熟慮
delineate - 描寫
deluge - 大洪水，湧現的事物
demanding - (a.)要求多的,吃力的
desiccate - 使脫水
despondent - 沮喪的
despotic - adj.專制的, 暴虐的
devil-may-care - 粗心大意的
discipline - 學科；訓練；處罰；紀律
disdain - 輕蔑
dismal - 悽慘的
dispatch - 發送，急件
disposal - 清除；處理；佈置
dispose - 去除；安排；使傾向於
dissolve - 溶解；解除
distinguished - 卓越的
divert - 轉移
do away with - 廢除
dogged - 頑強的
droop - 下垂；垂頭喪氣
dwindle - 減少
dwindle away - 逐漸消失
eccentric - adj. 古怪的、反常的
eclectic - 選擇的；折衷的
elapse - (v)消逝
elicit - 引出、誘出
eloquent - 能言善道的
elucidate - 闡明、說明
elusive - 難以捉摸的
emanate - 散發
emancipate - 解放
embark on - 開始，著手
emergence - 出現
emergent - 新興的
eminent - 知名的；傑出的
encroach - 入侵
enlist - 謀取，從軍
ensemble - 整體
ensuing - 接著發生的
entomb - 埋葬；設陷阱
entreat - 懇求
envision - 想像
ephemeral - 短暫的
epithet - 別名
erect - 垂直的，建立
essentially - 基本上
ethereal - 超凡的
euphoria - 愉悅感
evade - 逃避、規避
exasperating - 激怒人的
execute - 製作
exotic - 異國的，奇特的
expediency - 方便，權益之計
expedient - 有利的
expel - 驅逐，開除，排泄
explicit - 明確的
express - 明確的，快速的
exude - 散發、流露
fabricate - 製造
faction - 派別、黨派
faint - 微弱的，昏厥
faithful - 忠實的，準確可靠的
fallacious - 謬誤的
fare - 食物，票價
fashion - 形成
feign - 假裝
ferocious - 兇猛的
fidelity - 忠誠
fixation on - 著迷
for all - 儘管
formative - 對發展有幫助的，發展的
formidable - 強大的，艱鉅的，巨大的
fraction - 分數；小部分
fracture - 骨折，使破碎
fragmentary - 破碎的，不完全的
frail - 虛弱的，瘦弱的
frantic - 瘋狂的，忙亂的
frolic - 嬉戲
gallant - 勇敢的，殷勤的
gauge - 測量
gelatinous - 膠狀的
gem - 珠寶
genesis - (n)創始、起源
gentle - 上層階級的
genuine - 真正的；真誠的
gloom - 昏厥，憂鬱
gloomy - 憂鬱的
gracious - 親切的，仁慈的
groom - 梳毛、打扮、培養、訓練
grudging - 不情願的
gruesome - 可怕的；陰森的
guile - n. 欺詐，狡猾
hairline - 極細的
handicap - n.殘障,殘疾
harbor - (v)庇護;藏匿
havoc - 浩劫
headstrong - 固執的
hearten - v. 鼓勵，激勵
herald - 預示，宣告
hitherto - 到目前為止
hobble - 跛行;蹣跚
hurdle - 障礙(vt.)用籬笆圍,越過,克服
imbue - 灌輸、使充滿
immediate - 立即的，直接的，鄰近的
imminent - 即將發生的
impart - 傳授；給予；透漏
imperative - (adj)必要的、緊急的
impervious - 不受影響的
implicate - 暗示，牽連
imposing - (a.)令人難忘的,壯麗的,威風的
in sb's own right - 憑自己的能力
inaugurate - 舉行就職典禮；開創，創始
inauspicious - 不祥的 ; 凶兆的
incite - 煽動
incubate - 孵卵、醖釀
incur - v.招致
incursion - 侵略、入侵
indecent - 下流的，不妥當的
indefinitely - 無限期地
indelible - 擦拭不掉的，不可磨滅的
indigence - n. 貧窮
indiscriminate - 不加區別的，偶然的
indistinct - 不清楚的，模糊的；微弱的
induce - v. 引起；導致
inert - 惰性的；行動遲鈍的
infirm - 虛弱的
infuse - (v)灌輸、鼓勵
ingenious - (a.)靈敏的，精巧的，聰明的
ingenuous - (adj)純樸的、單純的
inordinate - 過度的，過分的
inroad - n. 突襲；（以犧牲他人為代價而取得的）進展
inscribe - 刻
insight into - 領悟
instigate - (v)發起、煽動
institute - 開創，設立
instructive - 有教育意義的
instrumental - 有幫助的
insular - 思想狹隘的
integrity - 正直,廉正,完整
intense - 強烈的；劇烈的；極端的
intermediate - 媒介；中間的
interpret - 理解
inundate - v. 使應接不暇;(洪水)淹沒
invaluable - 無價的
involved - 複雜的
irreparable - 不能挽回的
jinx - n.厄運、霉運
junction - 連接
juncture - 關鍵時刻；接合點
keen - 强烈的；熱切的；敏銳的
laborious - 費力的
lading - 貨物
lapse - 過失；流逝
lax - 鬆散的、不嚴格的
lead - 跡象
lease - 租約
legible - (a.)清晰的,易讀的
legitimacy - 合法；合理
lenient - 寬大的，仁慈的
lethargy - n. 昏睡; 倦怠; 呆滯懶散
liable - 負有法律責任的
liberal - 自由的，大方的
light - 鬆散的
limber - 柔軟的
lodge - 存放，嵌入；小屋
lodging - n. 寄宿處；住所
loiter - 閒晃
loom - 迫在眉睫
ludicrous - 荒唐的
luxuriant - 繁茂的、肥沃的
malnutrition - 營養不良
mandate - 授權，命令
mandatory - 強制的
manure - 糞肥
map - 詳細計畫
marginally - 少量地
mask - 遮掩；偽裝
mastery - 支配；統治
materialize - 實現；具體化
meager - 少量的，削瘦的
mediate - 調停
meridian - 子午線
methodical - 有條理的
mint - 鑄造，完好的
minutely - 仔細地
mirror - 反映；反射
mobilize - 動員
mock - 嘲笑；模仿
molest - 騷擾，調戲
momentous - 關鍵的
monotonous - 單調的
mortality - 死亡數；死亡率
multitudinous - 眾多的
mutilate - 使損傷
nerve - 勇氣
nibble - 細咬
nighttime - 夜間(的)
noted - 有名的
notwithstanding - 儘管
nuisance - 討厭的人事物
obligated - 有義務的
oblige - 強迫
oblique - 拐彎抹角的
oblivious - 未察覺的
obstinate - 頑固的
occasion - 場合；重大活動
occult - 神秘的
odds - 不一致，有分歧
odious - 令人討厭的
olfactory - 嗅覺的
omit - 刪除
onerous - (adj)繁重的、麻煩的
opaque - 不透明的、難懂的
opportune - 適當的
optic - 視覺的
opulent - 豪華的
ordeal - 折磨
ore - 礦石
orientation - 觀點
oscillate - 振盪，動搖
ostentatious - 炫耀的
outbreak - 爆發；突然發生
outlandish - 異國風格的，古怪的，偏僻的
outlying - 偏遠的
overdue - 過期的，早該有的
overlie - 覆蓋
pacify - 安撫
pare - (v.)修剪；削去；削減
patent - 專利，明顯的
pathway - 小徑
peculiarity - 特性、怪癖
pedestal - 基座，底座
pensive - 憂傷的
perennial - 長久的，多年生的
perimeter - 邊緣，周長
pertain - 屬於、關於
pertinent - 相關的
pervade - 彌漫；普及
pervert - 變態；使走上邪路
phenomenal - 非凡的
pioneering - 開創性的
placid - 文靜的
plain - 淺白的，直率的
plummet - 筆直落下
plunder - 搶劫
pragmatic - 務實的
prairie - 大草原
precipitate - (v)降水、加速、促成...發生
preclude - (v)避免、排除
preeminent - adj. 卓越的、顯著的
preface - 序言
preliminary - (adj)預備的、初步的
press - 報章雜志，新聞界
pressing - 緊迫的、迫切的
prevalent - (a.)普遍的，流行的
pricy - 昂貴的
procure - 取得
prodigious - 巨大的，驚人的
proficient - 熟練的
profuse - 大量的
programmed - 計畫的
prohibitive - 買不起的，禁止的
project - 展示；投射
projection - (n)預測、推測、估計
proliferation - n. 增殖; 擴散; 激增
prolific - 多產的
prominent - 傑出的，著名的
prompt - 促使；引起
pronounced - 明確的、明顯的
propagate - 繁殖
propitious - 有利的
proscribe - 正式禁止
provision - 供應，條款
prowess - 英勇，勇敢，超凡技術
pungent - 辛辣的；犀利的
purchase - 緊握
pursue - 追求；從事
put up - 建造，提供
quaint - 古色古香的
quarters - 住處
raise to - 造成
ramification - 分枝；結果；衍生物
rancid - 令人作嘔的，腐臭的
rapture - 狂喜
ratify - 批准
ration - 配給量
ready - 心甘情願的
recompense - 補償
recount - 講述
rectify - 糾正
regard for - 注意
regime - 政權
relinquish - 放棄
remark - 言論，評論
render - 使得；提供
rendering - 演出；翻譯
renown - （n.)名聲
rent - n.租金；房租
repel - 相斥，擊退
replenish - 補充
reside on - 靠...生活
resultant - 作為結果的
retard - 妨礙；減速
retard - 妨礙；減速
retrieve - v.找回；重新得到
revere - 尊敬
revoke - 撤銷
revolt - 反叛，憎惡
rigid - 堅硬的；嚴格的；死板的
rigorous - 嚴厲的，精確的
rupture - 破裂
sag - 下垂
salient - 顯著的
salutary - 有益的
save for - 除...之外
scant - 少量的、貧乏的
scanty - 不足的；欠缺的
scented - 具有香氣的
scorching - 酷熱的
score - 二十，刻痕，樂譜
scorn - 輕蔑
scour - 搜尋
screen - 過濾
scribe - 抄寫員
scrub - 擦洗
scruple - 顧忌
scrupulous - 一絲不苟的，正直審慎的
scrutinize - 詳細檢查
scrutiny - 詳細的的檢查
secede - 脫離
secession - n.脫離
secluded - 僻靜的
seclusion - 寂寞
seep - 滲透
seethe - 生悶氣，激動，動蕩
seething - 激昂的
segregate - 隔絕
sentiment - 情緒，意見，多愁善感
serendipitous - 偶然發現的，有益的
serene - 平靜的
set off - 出發
sever - 切開，中止
severity - 嚴重性
sharp - 尖銳的；嚴重的
sheer - 完全的
shore - 海岸
singularly - 异常地；特別地
snap - 斷裂
soak - 浸泡；吸收
solicit - 請求
solitude - 獨處
sovereign - (n)最高統治者、元首
Speciation - 物種形成
specify - 具體說明
spell - 魔力，魅力，一段時間
spell out - 解釋
splendor - (n)壯麗；光輝
sporadic - 偶發的
spottily - 缺乏連續性地
sprightly - 活潑的
spurt - 噴出；突然增大
staggering - 巨大的；驚人的
stagnate - 停滯
stamina - 精力，耐力
staunch - (adj)堅定的、忠誠的
stealthy - 秘密的、鬼鬼祟祟的
sterile - 不孕的，貧瘠的，無菌的
stipulation - 規定
strictly - 僅僅
strife - 衝突，競爭
strike - 受疾病侵襲
stringent - 嚴格的
strip - (v)剝去、剝光
stumble upon - 意外發現
sturdy - (a.)強健的,健全的
subdue - (v)征服、壓制
subsidiary - 次要的，附屬事務
subsidize - 給予補助
subsistent - 現存的
substantiate - 證實
suffice - (vi.)足夠,有能力(vt.)滿足
sumptuous - 奢侈的
superb - 卓越的
supersede - 取代
supplant - 取代
supple - 柔軟的
surmise - 猜測
surmount - 克服
susceptible - 易受影響的
suspend - 懸掛
sustenance - 生計，食物
sway - 搖擺，説服
tacit - 隱含的
tactual - 觸覺的
taint - 污染
taper - 逐漸變細
taut - 緊綳的
temper - 使和緩
tempting - 誘人的
tender - 柔軟的，和善的
tenuous - 微弱的，細的
tenuous - 脆弱的，無力的
tepid - 微溫的，不熱情的
term - （v.)稱作
terse - 簡要的
textural - a.質感的
think highly of - 對...評價很高
thwart - 阻撓
tracts of land - 大片土地
tranquil - 安靜的
transmute - 變化
transparent - 透明的，明顯的
traverse - (v)橫越、橫跨
tumultuous - 混亂的
turbulent - 混亂的
tyranny - 專制
umpire - 裁判
unambiguous - 明確的
unanimity - n.全體一致同意
unconsolidated - 鬆散的
uncouth - 粗野的
underline - 強調；構成...的基礎
underlying - 潛在的
underpin - 鞏固
underscore - 强調
undertake - 承擔，著手
undertaking - 承諾，事業
undue - 過度的
unqualified - 完全的，絕對的，沒資格的
unravel - 拆開，解決，厘清
unsurpassed - 無與倫比的
unwieldly - a 笨重的；難使用的
urbane - adj.彬彬有禮的, 文雅的
utilitarian - 實用性
utility - 效用，公用事業，多功的
vacate - 撤銷，撤離
vagarious - 奇特的
vagary - (n)奇想、難預測的變化
vagary - 變化莫測
vague - (a.)含糊的,不清楚的,茫然的
vat - 大桶
venerate - 敬重
venturous - 冒險的；大膽的
verdict - 陪審團的裁決
verse - 詩歌
viability - (n)生存能力、存活力
vial - 小瓶
vibrant - 精力充沛的，鮮明的，震動的
virtue - 優點
vocation - 志業
vogue - 流行，流行樣式
wallow - 打滾，沉迷於
wanting - 不友好的；欠缺的
wanton - 惡意的，不道德的
wary - 謹慎的
wax - 逐漸變成
well-concieved - 設想周到的
whereby - 藉以
wholesome - 有益健康的
wholly - adv.完全地
with respect to - 關於
wobble - （使）擺動
wooly - 毛茸茸的
wreck - 失事（的交通工具），毀壞
wry - 扭曲的；諷刺的
yearning - 渴望（的）
